10
S.........
.####.###.
..#.#...#.
..#.#.#.#.
..#...#.#.
..###.####
....#.....
###.#..G..
....#####.
....#.....
