20
....................
.....#.........#....
..#..######....#....
..##......##...#####
...#.......#........
..##....S..#........
..#.....#######.....
###....##.....#.....
.....##...G...###...
....##..........##..
....#............#..
....#............##.
...#......####....#.
...#.....##..#....#.
...#....##........#.
...##..##........##.
....####.......###..
...............#....
...............#....
...............#....
