20
##.######...#.......
##......##..#..###..
....S....##...##....
...###....##..##....
...#.###..##...###..
...#.#G.###......##.
...#....##..###...#.
...#.#...####.##..#.
.#.#.#####.....#..#.
.#.#...........##.#.
.#.########.....#.#.
.#.........#....#.#.
.#.####....#....#.#.
.###...#...###..#.#.
...........#.#..#.#.
....#######..#..#.#.
###.#........#....#.
..#.##..#....#....#.
..#....####..######.
.......####.........
