7
#.....#
#.....#
###.###
#S.#.G#
###.###
#.....#
#.###.#
